___M______
###_______
__X_######
_##_X_____
__X_#_____
_##_X_____
__X_##____
__X_##____
__X_X_____
###_X_____
