___M______
###_______
____######
_##_______
____#_____
_##_______
____##____
____##____
__________
###_______
