__________
__________
__________
__________
_+___+++__
__+_+#####
___+++++++
__+_______
________+_
____M_____

