__________
____#_____
____#_____
____#_____
__________
____#_____
____#_____
____#_____
__________
____M_____
