__________
__________
__________
___+_+____
___+#+____
___+#+____
___+++____
__________
____M_____
__________
