____#_____
____#_____
____#_____
+___#_____
+_____#___
+_++#_#___
X__+#_#___
_+++#_____
__________
____M_____
