__________
__________
__++++++__
__++++++__
__++++++__
__+++#####
__++++++++
__++++++++
______++++
XX__M_++++
