#X########
#X#XXXXXX#
#X#X######
#X#X#XXXXX
#X#X######
#X#XXXXXX#
#X#X######
###X#XXXXX
XXXX#XXXXX
XXXXMXXXXX
