____M_____
_###______
_____###__
#__#______
_____##_##
_#_#______
__________
#_##______
_____###_#
_____##_##
